Laberinto resuelto:
1 1 1 1 1 1 1 1 1 1 
1 0 0 1 0 0 0 0 0 1 
1 0 0 1 0 0 0 0 0 1 
1 0 0 1 0 0 1 0 0 1 
3 2 2 1 1 1 1 0 0 1 
1 0 0 2 2 2 2 2 2 4 
1 0 0 0 0 0 0 0 0 1 
1 0 0 1 1 1 1 0 0 1 
1 0 0 1 0 0 0 0 0 1 
1 0 0 1 0 0 0 0 0 1 
1 1 1 1 1 1 1 1 1 1 
