Iteración (movimiento) 2 - Agente se mueve a: (5, 1)  g=7
Camino recorrido por el agente (marcado con 2):
1 1 1 1 1 1 1 1 1 1 1 1 1 1 1 1 1 
1 0 0 0 1 0 0 0 0 0 0 0 0 0 0 0 1 
1 0 0 0 1 0 0 0 0 0 0 0 0 0 0 0 1 
1 0 0 0 1 0 0 0 0 0 0 0 0 0 0 0 1 
3 0 0 0 1 0 0 0 1 0 0 0 1 1 1 1 1 
1 * 0 0 1 0 0 0 1 0 0 0 1 0 0 0 1 
1 0 0 0 1 0 0 0 1 0 0 0 1 0 0 0 1 
1 0 0 0 1 0 0 0 1 0 0 0 1 0 0 0 1 
1 0 0 0 1 1 1 1 1 0 0 0 1 0 0 0 1 
1 0 0 0 0 0 0 0 0 0 0 0 1 0 0 0 1 
1 0 0 0 0 0 0 0 0 0 0 0 1 0 0 0 1 
1 0 0 0 0 0 0 0 0 0 0 0 1 0 0 0 1 
1 0 0 0 1 1 1 1 1 0 0 0 1 0 0 0 4 
1 0 0 0 1 0 0 0 0 0 0 0 0 0 0 0 1 
1 0 0 0 1 0 0 0 0 0 0 0 0 0 0 0 1 
1 0 0 0 1 0 0 0 0 0 0 0 0 0 0 0 1 
1 1 1 1 1 1 1 1 1 1 1 1 1 1 1 1 1 

Iteración (movimiento) 4 - Agente se mueve a: (6, 2)  g=14
Camino recorrido por el agente (marcado con 2):
0 0 1 1 0 1 0 0 0 0 0 1 1 1 0 0 1 
0 0 0 0 0 0 1 0 0 0 0 0 1 0 1 0 0 
0 1 0 0 0 1 0 0 0 0 1 0 0 0 0 0 0 
1 1 0 0 0 0 0 0 0 0 1 0 1 0 0 0 0 
3 0 0 0 0 0 1 0 0 0 0 1 1 0 0 0 1 
0 * 0 0 0 0 0 1 0 0 0 0 0 0 0 0 0 
0 0 * 0 0 0 0 0 0 0 0 0 0 0 0 0 0 
0 0 0 1 1 1 0 0 0 0 1 0 0 0 0 1 1 
0 1 0 0 0 0 0 1 0 0 0 0 0 1 0 0 0 
0 0 0 0 0 1 0 0 0 1 0 1 1 1 0 0 0 
0 1 0 0 1 1 0 1 0 0 0 1 1 0 0 0 0 
0 0 1 1 1 1 1 1 0 0 0 1 0 0 1 1 1 
1 0 0 1 0 0 1 0 1 1 0 0 0 0 0 0 4 
0 0 0 0 0 1 1 0 0 0 0 0 0 0 0 0 0 
0 0 0 1 0 0 0 0 0 0 0 0 0 0 0 1 0 
0 0 0 1 0 0 0 1 0 0 1 0 1 0 0 0 0 
0 1 0 0 1 1 1 0 0 0 0 0 1 1 1 0 0 

Iteración (movimiento) 7 - Agente se mueve a: (6, 3)  g=19
Camino recorrido por el agente (marcado con 2):
1 0 0 1 0 0 0 0 0 0 1 0 0 1 0 1 0 
1 0 0 0 0 0 0 0 0 0 0 0 1 1 0 0 0 
0 0 1 0 1 0 0 0 0 0 1 0 0 0 0 0 0 
0 0 0 1 0 0 0 1 0 0 0 1 1 0 0 0 0 
3 0 0 0 0 1 0 0 0 0 1 1 0 0 0 0 0 
0 * 1 0 0 1 0 0 0 1 0 0 1 0 0 0 0 
1 0 * * 0 0 0 1 0 0 0 0 1 1 0 0 0 
1 0 0 1 0 1 1 0 0 1 0 0 0 0 0 1 0 
0 0 0 0 0 0 0 0 0 0 0 0 1 0 1 1 0 
0 0 0 0 0 1 0 0 0 0 0 1 1 0 0 0 1 
0 0 1 0 0 1 0 0 1 0 0 1 1 1 0 0 0 
0 0 0 0 0 0 0 0 1 0 1 1 0 0 0 0 1 
0 0 0 0 1 1 0 1 0 1 0 1 0 0 0 0 4 
0 0 1 1 0 0 1 1 0 1 0 1 0 0 0 0 0 
0 0 0 1 0 0 0 1 0 0 0 0 0 0 0 1 0 
1 0 1 0 1 1 0 0 0 0 1 0 0 0 0 0 0 
0 1 0 0 1 0 0 0 0 0 0 0 0 0 1 0 1 

Iteración (movimiento) 9 - Agente se mueve a: (7, 4)  g=26
Camino recorrido por el agente (marcado con 2):
0 0 0 0 1 0 0 0 0 0 1 0 0 0 0 0 0 
0 1 0 0 0 1 0 0 0 0 0 0 0 1 0 0 0 
0 0 0 0 0 0 0 0 0 0 1 0 0 1 1 0 0 
0 0 0 1 0 0 1 0 0 0 0 1 0 0 0 1 0 
3 1 0 0 1 1 0 0 1 0 0 1 0 0 0 1 0 
0 * 0 0 1 0 0 1 0 0 0 0 1 0 0 0 0 
0 0 * * 1 0 0 0 0 0 1 0 0 0 1 0 1 
0 0 1 0 * 0 0 0 0 0 0 0 0 0 1 0 0 
1 0 0 0 1 0 0 0 1 0 0 0 0 0 0 0 0 
1 0 0 0 0 0 0 0 0 0 1 0 0 0 0 0 1 
0 1 1 0 0 1 0 1 1 1 0 0 0 0 0 0 0 
0 1 0 1 0 0 1 1 0 0 0 1 1 0 0 0 0 
1 0 0 0 0 1 0 0 0 1 0 0 0 0 0 0 4 
1 0 0 0 1 0 0 0 0 1 0 0 0 0 0 1 1 
1 0 1 0 0 0 1 0 0 1 1 0 1 0 1 0 0 
1 1 0 0 0 0 1 0 0 1 0 0 0 0 0 1 0 
0 1 0 0 1 0 0 1 0 1 0 0 0 1 1 0 1 

Iteración (movimiento) 11 - Agente se mueve a: (8, 5)  g=33
Camino recorrido por el agente (marcado con 2):
0 1 0 0 0 0 0 0 0 0 0 0 1 0 0 0 0 
0 0 0 0 0 0 0 1 0 1 1 0 1 0 1 1 0 
0 0 1 0 0 0 0 1 1 0 0 0 0 1 0 1 1 
1 0 1 0 0 0 0 1 0 0 0 1 1 0 0 0 0 
3 0 0 0 0 1 0 1 1 0 1 1 0 0 0 0 1 
0 * 1 0 0 0 0 1 0 0 0 1 0 1 0 0 0 
0 0 * * 1 0 0 1 0 0 0 1 0 0 0 1 0 
0 1 0 0 * 1 0 0 1 0 0 0 1 0 0 1 0 
0 0 0 0 0 * 0 0 0 0 0 1 0 0 0 0 0 
0 0 0 0 0 0 0 0 0 0 0 0 0 1 1 0 1 
1 1 0 1 0 0 0 0 0 0 0 0 0 0 0 0 0 
0 1 0 0 0 0 0 0 0 0 0 0 1 1 0 0 0 
1 1 0 1 0 0 0 0 0 1 1 1 1 0 0 0 4 
0 0 0 1 0 0 0 0 0 0 1 0 0 0 1 0 0 
1 0 1 0 0 0 0 0 0 1 0 0 0 1 0 0 0 
0 0 0 0 1 0 0 0 0 0 1 1 0 0 1 0 1 
1 0 0 1 1 0 0 0 1 0 0 0 0 1 0 0 0 

Iteración (movimiento) 18 - Agente se mueve a: (9, 6)  g=40
Camino recorrido por el agente (marcado con 2):
1 0 0 1 0 1 1 0 1 1 0 0 0 0 0 0 0 
0 0 0 0 0 1 0 0 1 1 0 1 0 0 1 0 1 
0 1 0 0 0 1 0 0 0 0 1 1 1 0 0 0 0 
0 0 0 0 0 0 0 0 1 0 1 0 0 0 0 0 1 
3 0 0 0 0 0 0 0 1 0 0 0 0 0 0 0 0 
0 * 0 0 0 0 0 0 0 0 0 0 0 0 1 1 0 
1 0 * * 1 0 0 0 0 0 0 0 0 0 0 1 0 
0 0 0 1 * 0 1 0 0 0 0 1 0 0 1 1 1 
0 0 0 0 0 * 1 0 1 0 1 0 1 1 0 0 0 
0 0 0 0 0 0 * 0 1 0 0 0 0 1 0 0 1 
0 0 0 0 0 0 0 1 0 0 0 1 0 1 0 0 0 
0 1 0 0 0 1 0 0 1 0 0 0 0 0 0 1 0 
0 1 0 0 1 0 0 0 0 0 0 0 1 1 0 0 4 
1 0 0 1 0 1 0 0 1 1 1 0 0 0 1 0 0 
0 0 1 1 0 0 0 0 0 0 0 0 1 0 0 1 0 
1 0 0 0 0 0 0 0 1 0 0 1 1 0 0 1 0 
1 0 0 0 0 1 0 0 0 0 1 1 0 1 0 0 0 

Iteración (movimiento) 30 - Agente se mueve a: (10, 6)  g=45
Camino recorrido por el agente (marcado con 2):
1 0 0 0 0 0 0 0 0 0 0 0 0 0 0 0 0 
1 0 1 0 0 0 0 1 0 0 0 0 1 0 0 0 1 
0 0 0 0 1 0 0 1 0 0 0 0 1 0 0 0 0 
0 1 1 0 1 1 0 0 0 1 0 1 0 0 1 0 0 
3 0 0 0 0 0 0 1 1 0 1 0 1 0 0 0 0 
0 * 1 1 0 1 0 0 0 0 1 0 0 0 1 0 0 
0 0 * * 0 0 0 0 1 0 0 0 1 0 0 0 1 
0 0 0 0 * 0 0 0 1 0 1 0 0 0 1 0 0 
0 0 0 0 0 * 0 0 0 0 0 1 1 0 0 0 0 
0 1 0 0 1 1 * 1 0 1 0 0 0 0 0 0 0 
0 0 0 1 0 1 * 0 1 1 0 0 0 1 0 0 0 
0 0 1 0 0 0 0 0 0 1 0 0 0 1 0 0 0 
0 1 1 0 0 0 0 0 1 1 0 0 1 0 0 0 4 
1 0 1 1 0 1 0 0 1 1 0 1 0 0 0 0 0 
0 1 0 1 1 0 0 1 0 0 0 0 0 0 1 0 0 
0 0 0 0 0 1 0 1 0 0 1 0 1 0 0 0 1 
1 1 0 0 0 0 1 0 0 0 0 1 0 0 0 0 0 

Iteración (movimiento) 33 - Agente se mueve a: (11, 7)  g=52
Camino recorrido por el agente (marcado con 2):
1 0 0 0 0 0 0 0 0 0 0 0 1 0 0 0 0 
0 0 1 0 0 0 0 1 0 0 0 0 1 1 0 0 1 
1 0 0 0 0 0 1 0 0 0 0 1 0 0 1 0 1 
0 0 0 0 0 0 1 0 0 0 1 0 0 0 1 0 1 
3 0 0 1 0 0 0 0 0 0 1 0 0 1 0 0 0 
0 * 0 1 1 1 0 0 1 0 0 0 1 0 1 0 0 
1 0 * * 0 1 0 0 0 0 0 0 0 0 0 1 1 
1 0 0 0 * 1 0 0 0 0 1 0 0 0 0 0 1 
1 0 1 0 0 * 0 0 0 0 0 0 0 0 1 1 0 
0 1 0 0 1 0 * 0 0 1 0 0 0 0 0 0 0 
0 1 1 0 1 0 * 0 0 1 0 1 0 0 0 1 0 
1 0 0 0 1 0 1 * 0 0 0 0 0 0 1 0 0 
1 1 0 0 0 0 0 0 0 0 0 0 0 0 0 0 4 
0 0 0 0 0 0 1 0 0 0 0 0 0 0 1 0 0 
1 1 0 0 0 0 0 1 0 1 0 0 0 1 1 0 1 
0 0 0 1 0 0 0 1 0 0 0 1 0 0 1 1 0 
0 1 0 0 0 0 1 0 0 0 1 1 1 0 0 0 1 

Iteración (movimiento) 36 - Agente se mueve a: (12, 8)  g=59
Camino recorrido por el agente (marcado con 2):
1 0 0 1 0 0 0 0 0 1 0 1 0 1 0 0 0 
0 1 0 0 0 0 1 0 0 0 0 0 0 1 0 1 0 
0 1 0 0 0 0 0 0 0 1 0 0 0 0 0 0 1 
0 1 0 0 0 0 1 0 1 0 0 1 0 0 1 1 1 
3 0 0 0 1 0 0 1 0 0 1 0 1 0 0 1 0 
0 * 0 0 1 0 0 0 0 0 0 1 0 0 0 1 1 
0 0 * * 1 1 0 1 0 0 0 0 1 0 0 0 1 
0 0 0 0 * 0 0 0 1 0 1 1 0 0 0 0 0 
1 0 0 0 0 * 0 0 0 0 1 0 0 0 0 1 0 
1 0 1 0 0 0 * 0 0 1 0 0 1 0 0 0 0 
0 0 0 0 0 0 * 0 0 0 0 1 0 1 0 1 1 
0 0 0 0 0 0 0 * 1 0 0 1 0 1 1 0 0 
0 0 0 1 0 0 0 0 * 0 0 1 1 0 1 0 4 
0 1 0 1 1 0 0 0 0 1 1 0 0 0 0 0 0 
1 0 0 0 1 0 0 0 0 0 0 0 0 1 0 0 1 
0 0 0 0 0 0 1 0 0 0 0 0 0 0 1 0 0 
0 1 1 0 1 0 0 0 0 0 1 1 0 0 0 1 0 

Iteración (movimiento) 75 - Agente se mueve a: (11, 9)  g=66
Camino recorrido por el agente (marcado con 2):
0 0 0 0 0 1 0 0 0 0 0 0 0 1 0 0 1 
0 0 1 0 0 0 0 0 0 1 0 0 1 1 0 0 0 
0 1 1 0 0 0 1 1 1 0 0 0 0 1 0 0 0 
1 0 1 0 0 0 0 0 0 0 0 0 0 0 0 1 0 
3 0 0 1 0 1 0 0 0 0 0 0 0 0 0 0 0 
0 * 0 0 1 0 1 0 0 0 1 0 0 0 1 0 0 
0 0 * * 1 1 1 1 0 1 0 1 0 0 0 1 1 
0 0 0 0 * 0 0 0 0 0 1 0 0 0 0 0 0 
0 0 0 0 0 * 0 0 1 0 0 0 0 0 0 0 0 
0 0 1 1 0 0 * 1 1 0 1 0 0 0 1 0 0 
1 0 0 0 1 0 * 1 1 1 0 0 1 1 0 0 0 
1 0 1 1 0 0 0 * 0 * 1 1 0 0 1 0 0 
0 1 0 1 1 0 0 0 * 0 0 0 0 0 0 0 4 
0 0 0 0 1 1 1 0 0 0 0 0 0 0 0 0 0 
0 0 1 1 1 1 0 0 0 0 0 0 0 0 1 0 0 
0 1 0 0 1 0 0 0 0 0 0 0 1 0 1 1 1 
0 0 0 1 1 0 0 1 0 1 0 0 0 0 0 0 0 

Laberinto dinámico resuelto:
Número de muros: 70
Porcentaje de muros: 24.2215%
Entrada: (4, 0)
Salida: (12, 16)
Coste: 104
Número de nodos generados: 193
Número de nodos inspeccionados: 154
Laberinto actual:
0 0 0 0 0 0 1 0 0 0 1 1 0 0 0 1 0 
0 1 0 1 0 0 0 0 1 0 0 1 1 0 0 0 0 
0 0 0 1 0 1 0 0 1 1 1 0 0 0 1 0 0 
1 0 1 0 0 0 1 1 0 0 1 0 1 0 0 0 0 
3 0 0 1 0 0 0 1 0 0 0 0 0 0 0 1 0 
0 * 0 0 0 1 0 1 0 0 0 1 0 0 0 0 0 
0 1 * * 0 0 0 1 0 0 0 0 0 1 1 0 1 
0 0 1 1 * 0 0 1 1 0 1 0 0 0 0 0 1 
0 0 0 0 0 * * 0 0 0 0 1 0 0 0 1 0 
0 0 1 1 0 0 0 * * 0 0 * 0 0 0 0 0 
0 0 1 1 0 1 0 0 0 * * 0 * 0 1 0 0 
1 0 0 1 0 0 1 0 1 0 0 0 0 * 0 * 0 
0 0 0 1 1 0 0 1 0 0 1 0 0 1 * 0 4 
0 0 0 0 1 0 1 0 0 0 1 0 1 0 0 0 0 
0 0 0 0 0 0 1 0 1 1 0 0 1 0 0 0 0 
0 0 0 1 0 0 0 0 0 0 0 1 0 0 1 0 0 
1 0 0 0 1 0 1 0 0 0 0 1 0 0 0 0 0 
