Iteración (movimiento) 2 - Agente se mueve a: (5, 1)  g=7
Camino recorrido por el agente (marcado con 2):
1 1 1 1 1 1 1 1 1 1 1 1 1 1 1 1 1 
1 0 0 0 1 0 0 0 0 0 0 0 0 0 0 0 1 
1 0 0 0 1 0 0 0 0 0 0 0 0 0 0 0 1 
1 0 0 0 1 0 0 0 0 0 0 0 0 0 0 0 1 
3 0 0 0 1 0 0 0 1 0 0 0 1 1 1 1 1 
1 * 0 0 1 0 0 0 1 0 0 0 1 0 0 0 1 
1 0 0 0 1 0 0 0 1 0 0 0 1 0 0 0 1 
1 0 0 0 1 0 0 0 1 0 0 0 1 0 0 0 1 
1 0 0 0 1 1 1 1 1 0 0 0 1 0 0 0 1 
1 0 0 0 0 0 0 0 0 0 0 0 1 0 0 0 1 
1 0 0 0 0 0 0 0 0 0 0 0 1 0 0 0 1 
1 0 0 0 0 0 0 0 0 0 0 0 1 0 0 0 1 
1 0 0 0 1 1 1 1 1 0 0 0 1 0 0 0 4 
1 0 0 0 1 0 0 0 0 0 0 0 0 0 0 0 1 
1 0 0 0 1 0 0 0 0 0 0 0 0 0 0 0 1 
1 0 0 0 1 0 0 0 0 0 0 0 0 0 0 0 1 
1 1 1 1 1 1 1 1 1 1 1 1 1 1 1 1 1 

Iteración (movimiento) 4 - Agente se mueve a: (6, 2)  g=14
Camino recorrido por el agente (marcado con 2):
1 1 1 1 1 1 1 1 1 1 1 1 1 1 1 1 1 
1 0 0 0 1 0 0 0 0 0 0 0 0 0 0 0 1 
1 0 0 0 1 0 0 0 0 0 0 0 0 0 0 0 1 
1 0 0 0 1 0 0 0 0 0 0 0 0 0 0 0 1 
3 0 0 0 1 0 0 0 1 0 0 0 1 1 1 1 1 
1 * 0 0 1 0 0 0 1 0 0 0 1 0 0 0 1 
1 0 * 0 1 0 0 0 1 0 0 0 1 0 0 0 1 
1 0 0 0 1 0 0 0 1 0 0 0 1 0 0 0 1 
1 0 0 0 1 1 1 1 1 0 0 0 1 0 0 0 1 
1 0 0 0 0 0 0 0 0 0 0 0 1 0 0 0 1 
1 0 0 0 0 0 0 0 0 0 0 0 1 0 0 0 1 
1 0 0 0 0 0 0 0 0 0 0 0 1 0 0 0 1 
1 0 0 0 1 1 1 1 1 0 0 0 1 0 0 0 4 
1 0 0 0 1 0 0 0 0 0 0 0 0 0 0 0 1 
1 0 0 0 1 0 0 0 0 0 0 0 0 0 0 0 1 
1 0 0 0 1 0 0 0 0 0 0 0 0 0 0 0 1 
1 1 1 1 1 1 1 1 1 1 1 1 1 1 1 1 1 

Iteración (movimiento) 7 - Agente se mueve a: (7, 3)  g=21
Camino recorrido por el agente (marcado con 2):
1 1 1 1 1 1 1 1 1 1 1 1 1 1 1 1 1 
1 0 0 0 1 0 0 0 0 0 0 0 0 0 0 0 1 
1 0 0 0 1 0 0 0 0 0 0 0 0 0 0 0 1 
1 0 0 0 1 0 0 0 0 0 0 0 0 0 0 0 1 
3 0 0 0 1 0 0 0 1 0 0 0 1 1 1 1 1 
1 * 0 0 1 0 0 0 1 0 0 0 1 0 0 0 1 
1 0 * 0 1 0 0 0 1 0 0 0 1 0 0 0 1 
1 0 0 * 1 0 0 0 1 0 0 0 1 0 0 0 1 
1 0 0 0 1 1 1 1 1 0 0 0 1 0 0 0 1 
1 0 0 0 0 0 0 0 0 0 0 0 1 0 0 0 1 
1 0 0 0 0 0 0 0 0 0 0 0 1 0 0 0 1 
1 0 0 0 0 0 0 0 0 0 0 0 1 0 0 0 1 
1 0 0 0 1 1 1 1 1 0 0 0 1 0 0 0 4 
1 0 0 0 1 0 0 0 0 0 0 0 0 0 0 0 1 
1 0 0 0 1 0 0 0 0 0 0 0 0 0 0 0 1 
1 0 0 0 1 0 0 0 0 0 0 0 0 0 0 0 1 
1 1 1 1 1 1 1 1 1 1 1 1 1 1 1 1 1 

Iteración (movimiento) 10 - Agente se mueve a: (8, 3)  g=26
Camino recorrido por el agente (marcado con 2):
1 1 1 1 1 1 1 1 1 1 1 1 1 1 1 1 1 
1 0 0 0 1 0 0 0 0 0 0 0 0 0 0 0 1 
1 0 0 0 1 0 0 0 0 0 0 0 0 0 0 0 1 
1 0 0 0 1 0 0 0 0 0 0 0 0 0 0 0 1 
3 0 0 0 1 0 0 0 1 0 0 0 1 1 1 1 1 
1 * 0 0 1 0 0 0 1 0 0 0 1 0 0 0 1 
1 0 * 0 1 0 0 0 1 0 0 0 1 0 0 0 1 
1 0 0 * 1 0 0 0 1 0 0 0 1 0 0 0 1 
1 0 0 * 1 1 1 1 1 0 0 0 1 0 0 0 1 
1 0 0 0 0 0 0 0 0 0 0 0 1 0 0 0 1 
1 0 0 0 0 0 0 0 0 0 0 0 1 0 0 0 1 
1 0 0 0 0 0 0 0 0 0 0 0 1 0 0 0 1 
1 0 0 0 1 1 1 1 1 0 0 0 1 0 0 0 4 
1 0 0 0 1 0 0 0 0 0 0 0 0 0 0 0 1 
1 0 0 0 1 0 0 0 0 0 0 0 0 0 0 0 1 
1 0 0 0 1 0 0 0 0 0 0 0 0 0 0 0 1 
1 1 1 1 1 1 1 1 1 1 1 1 1 1 1 1 1 

Iteración (movimiento) 11 - Agente se mueve a: (9, 4)  g=33
Camino recorrido por el agente (marcado con 2):
1 1 1 1 1 1 1 1 1 1 1 1 1 1 1 1 1 
1 0 0 0 1 0 0 0 0 0 0 0 0 0 0 0 1 
1 0 0 0 1 0 0 0 0 0 0 0 0 0 0 0 1 
1 0 0 0 1 0 0 0 0 0 0 0 0 0 0 0 1 
3 0 0 0 1 0 0 0 1 0 0 0 1 1 1 1 1 
1 * 0 0 1 0 0 0 1 0 0 0 1 0 0 0 1 
1 0 * 0 1 0 0 0 1 0 0 0 1 0 0 0 1 
1 0 0 * 1 0 0 0 1 0 0 0 1 0 0 0 1 
1 0 0 * 1 1 1 1 1 0 0 0 1 0 0 0 1 
1 0 0 0 * 0 0 0 0 0 0 0 1 0 0 0 1 
1 0 0 0 0 0 0 0 0 0 0 0 1 0 0 0 1 
1 0 0 0 0 0 0 0 0 0 0 0 1 0 0 0 1 
1 0 0 0 1 1 1 1 1 0 0 0 1 0 0 0 4 
1 0 0 0 1 0 0 0 0 0 0 0 0 0 0 0 1 
1 0 0 0 1 0 0 0 0 0 0 0 0 0 0 0 1 
1 0 0 0 1 0 0 0 0 0 0 0 0 0 0 0 1 
1 1 1 1 1 1 1 1 1 1 1 1 1 1 1 1 1 

Iteración (movimiento) 13 - Agente se mueve a: (10, 5)  g=40
Camino recorrido por el agente (marcado con 2):
1 1 1 1 1 1 1 1 1 1 1 1 1 1 1 1 1 
1 0 0 0 1 0 0 0 0 0 0 0 0 0 0 0 1 
1 0 0 0 1 0 0 0 0 0 0 0 0 0 0 0 1 
1 0 0 0 1 0 0 0 0 0 0 0 0 0 0 0 1 
3 0 0 0 1 0 0 0 1 0 0 0 1 1 1 1 1 
1 * 0 0 1 0 0 0 1 0 0 0 1 0 0 0 1 
1 0 * 0 1 0 0 0 1 0 0 0 1 0 0 0 1 
1 0 0 * 1 0 0 0 1 0 0 0 1 0 0 0 1 
1 0 0 * 1 1 1 1 1 0 0 0 1 0 0 0 1 
1 0 0 0 * 0 0 0 0 0 0 0 1 0 0 0 1 
1 0 0 0 0 * 0 0 0 0 0 0 1 0 0 0 1 
1 0 0 0 0 0 0 0 0 0 0 0 1 0 0 0 1 
1 0 0 0 1 1 1 1 1 0 0 0 1 0 0 0 4 
1 0 0 0 1 0 0 0 0 0 0 0 0 0 0 0 1 
1 0 0 0 1 0 0 0 0 0 0 0 0 0 0 0 1 
1 0 0 0 1 0 0 0 0 0 0 0 0 0 0 0 1 
1 1 1 1 1 1 1 1 1 1 1 1 1 1 1 1 1 

Iteración (movimiento) 18 - Agente se mueve a: (11, 6)  g=47
Camino recorrido por el agente (marcado con 2):
1 1 1 1 1 1 1 1 1 1 1 1 1 1 1 1 1 
1 0 0 0 1 0 0 0 0 0 0 0 0 0 0 0 1 
1 0 0 0 1 0 0 0 0 0 0 0 0 0 0 0 1 
1 0 0 0 1 0 0 0 0 0 0 0 0 0 0 0 1 
3 0 0 0 1 0 0 0 1 0 0 0 1 1 1 1 1 
1 * 0 0 1 0 0 0 1 0 0 0 1 0 0 0 1 
1 0 * 0 1 0 0 0 1 0 0 0 1 0 0 0 1 
1 0 0 * 1 0 0 0 1 0 0 0 1 0 0 0 1 
1 0 0 * 1 1 1 1 1 0 0 0 1 0 0 0 1 
1 0 0 0 * 0 0 0 0 0 0 0 1 0 0 0 1 
1 0 0 0 0 * 0 0 0 0 0 0 1 0 0 0 1 
1 0 0 0 0 0 * 0 0 0 0 0 1 0 0 0 1 
1 0 0 0 1 1 1 1 1 0 0 0 1 0 0 0 4 
1 0 0 0 1 0 0 0 0 0 0 0 0 0 0 0 1 
1 0 0 0 1 0 0 0 0 0 0 0 0 0 0 0 1 
1 0 0 0 1 0 0 0 0 0 0 0 0 0 0 0 1 
1 1 1 1 1 1 1 1 1 1 1 1 1 1 1 1 1 

Iteración (movimiento) 26 - Agente se mueve a: (11, 7)  g=52
Camino recorrido por el agente (marcado con 2):
1 1 1 1 1 1 1 1 1 1 1 1 1 1 1 1 1 
1 0 0 0 1 0 0 0 0 0 0 0 0 0 0 0 1 
1 0 0 0 1 0 0 0 0 0 0 0 0 0 0 0 1 
1 0 0 0 1 0 0 0 0 0 0 0 0 0 0 0 1 
3 0 0 0 1 0 0 0 1 0 0 0 1 1 1 1 1 
1 * 0 0 1 0 0 0 1 0 0 0 1 0 0 0 1 
1 0 * 0 1 0 0 0 1 0 0 0 1 0 0 0 1 
1 0 0 * 1 0 0 0 1 0 0 0 1 0 0 0 1 
1 0 0 * 1 1 1 1 1 0 0 0 1 0 0 0 1 
1 0 0 0 * 0 0 0 0 0 0 0 1 0 0 0 1 
1 0 0 0 0 * 0 0 0 0 0 0 1 0 0 0 1 
1 0 0 0 0 0 * * 0 0 0 0 1 0 0 0 1 
1 0 0 0 1 1 1 1 1 0 0 0 1 0 0 0 4 
1 0 0 0 1 0 0 0 0 0 0 0 0 0 0 0 1 
1 0 0 0 1 0 0 0 0 0 0 0 0 0 0 0 1 
1 0 0 0 1 0 0 0 0 0 0 0 0 0 0 0 1 
1 1 1 1 1 1 1 1 1 1 1 1 1 1 1 1 1 

Iteración (movimiento) 28 - Agente se mueve a: (11, 8)  g=57
Camino recorrido por el agente (marcado con 2):
1 1 1 1 1 1 1 1 1 1 1 1 1 1 1 1 1 
1 0 0 0 1 0 0 0 0 0 0 0 0 0 0 0 1 
1 0 0 0 1 0 0 0 0 0 0 0 0 0 0 0 1 
1 0 0 0 1 0 0 0 0 0 0 0 0 0 0 0 1 
3 0 0 0 1 0 0 0 1 0 0 0 1 1 1 1 1 
1 * 0 0 1 0 0 0 1 0 0 0 1 0 0 0 1 
1 0 * 0 1 0 0 0 1 0 0 0 1 0 0 0 1 
1 0 0 * 1 0 0 0 1 0 0 0 1 0 0 0 1 
1 0 0 * 1 1 1 1 1 0 0 0 1 0 0 0 1 
1 0 0 0 * 0 0 0 0 0 0 0 1 0 0 0 1 
1 0 0 0 0 * 0 0 0 0 0 0 1 0 0 0 1 
1 0 0 0 0 0 * * * 0 0 0 1 0 0 0 1 
1 0 0 0 1 1 1 1 1 0 0 0 1 0 0 0 4 
1 0 0 0 1 0 0 0 0 0 0 0 0 0 0 0 1 
1 0 0 0 1 0 0 0 0 0 0 0 0 0 0 0 1 
1 0 0 0 1 0 0 0 0 0 0 0 0 0 0 0 1 
1 1 1 1 1 1 1 1 1 1 1 1 1 1 1 1 1 

Iteración (movimiento) 31 - Agente se mueve a: (12, 9)  g=64
Camino recorrido por el agente (marcado con 2):
1 1 1 1 1 1 1 1 1 1 1 1 1 1 1 1 1 
1 0 0 0 1 0 0 0 0 0 0 0 0 0 0 0 1 
1 0 0 0 1 0 0 0 0 0 0 0 0 0 0 0 1 
1 0 0 0 1 0 0 0 0 0 0 0 0 0 0 0 1 
3 0 0 0 1 0 0 0 1 0 0 0 1 1 1 1 1 
1 * 0 0 1 0 0 0 1 0 0 0 1 0 0 0 1 
1 0 * 0 1 0 0 0 1 0 0 0 1 0 0 0 1 
1 0 0 * 1 0 0 0 1 0 0 0 1 0 0 0 1 
1 0 0 * 1 1 1 1 1 0 0 0 1 0 0 0 1 
1 0 0 0 * 0 0 0 0 0 0 0 1 0 0 0 1 
1 0 0 0 0 * 0 0 0 0 0 0 1 0 0 0 1 
1 0 0 0 0 0 * * * 0 0 0 1 0 0 0 1 
1 0 0 0 1 1 1 1 1 * 0 0 1 0 0 0 4 
1 0 0 0 1 0 0 0 0 0 0 0 0 0 0 0 1 
1 0 0 0 1 0 0 0 0 0 0 0 0 0 0 0 1 
1 0 0 0 1 0 0 0 0 0 0 0 0 0 0 0 1 
1 1 1 1 1 1 1 1 1 1 1 1 1 1 1 1 1 

Iteración (movimiento) 41 - Agente se mueve a: (12, 10)  g=69
Camino recorrido por el agente (marcado con 2):
1 1 1 1 1 1 1 1 1 1 1 1 1 1 1 1 1 
1 0 0 0 1 0 0 0 0 0 0 0 0 0 0 0 1 
1 0 0 0 1 0 0 0 0 0 0 0 0 0 0 0 1 
1 0 0 0 1 0 0 0 0 0 0 0 0 0 0 0 1 
3 0 0 0 1 0 0 0 1 0 0 0 1 1 1 1 1 
1 * 0 0 1 0 0 0 1 0 0 0 1 0 0 0 1 
1 0 * 0 1 0 0 0 1 0 0 0 1 0 0 0 1 
1 0 0 * 1 0 0 0 1 0 0 0 1 0 0 0 1 
1 0 0 * 1 1 1 1 1 0 0 0 1 0 0 0 1 
1 0 0 0 * 0 0 0 0 0 0 0 1 0 0 0 1 
1 0 0 0 0 * 0 0 0 0 0 0 1 0 0 0 1 
1 0 0 0 0 0 * * * 0 0 0 1 0 0 0 1 
1 0 0 0 1 1 1 1 1 * * 0 1 0 0 0 4 
1 0 0 0 1 0 0 0 0 0 0 0 0 0 0 0 1 
1 0 0 0 1 0 0 0 0 0 0 0 0 0 0 0 1 
1 0 0 0 1 0 0 0 0 0 0 0 0 0 0 0 1 
1 1 1 1 1 1 1 1 1 1 1 1 1 1 1 1 1 

Iteración (movimiento) 46 - Agente se mueve a: (12, 11)  g=74
Camino recorrido por el agente (marcado con 2):
1 1 1 1 1 1 1 1 1 1 1 1 1 1 1 1 1 
1 0 0 0 1 0 0 0 0 0 0 0 0 0 0 0 1 
1 0 0 0 1 0 0 0 0 0 0 0 0 0 0 0 1 
1 0 0 0 1 0 0 0 0 0 0 0 0 0 0 0 1 
3 0 0 0 1 0 0 0 1 0 0 0 1 1 1 1 1 
1 * 0 0 1 0 0 0 1 0 0 0 1 0 0 0 1 
1 0 * 0 1 0 0 0 1 0 0 0 1 0 0 0 1 
1 0 0 * 1 0 0 0 1 0 0 0 1 0 0 0 1 
1 0 0 * 1 1 1 1 1 0 0 0 1 0 0 0 1 
1 0 0 0 * 0 0 0 0 0 0 0 1 0 0 0 1 
1 0 0 0 0 * 0 0 0 0 0 0 1 0 0 0 1 
1 0 0 0 0 0 * * * 0 0 0 1 0 0 0 1 
1 0 0 0 1 1 1 1 1 * * * 1 0 0 0 4 
1 0 0 0 1 0 0 0 0 0 0 0 0 0 0 0 1 
1 0 0 0 1 0 0 0 0 0 0 0 0 0 0 0 1 
1 0 0 0 1 0 0 0 0 0 0 0 0 0 0 0 1 
1 1 1 1 1 1 1 1 1 1 1 1 1 1 1 1 1 

Iteración (movimiento) 63 - Agente se mueve a: (13, 12)  g=81
Camino recorrido por el agente (marcado con 2):
1 1 1 1 1 1 1 1 1 1 1 1 1 1 1 1 1 
1 0 0 0 1 0 0 0 0 0 0 0 0 0 0 0 1 
1 0 0 0 1 0 0 0 0 0 0 0 0 0 0 0 1 
1 0 0 0 1 0 0 0 0 0 0 0 0 0 0 0 1 
3 0 0 0 1 0 0 0 1 0 0 0 1 1 1 1 1 
1 * 0 0 1 0 0 0 1 0 0 0 1 0 0 0 1 
1 0 * 0 1 0 0 0 1 0 0 0 1 0 0 0 1 
1 0 0 * 1 0 0 0 1 0 0 0 1 0 0 0 1 
1 0 0 * 1 1 1 1 1 0 0 0 1 0 0 0 1 
1 0 0 0 * 0 0 0 0 0 0 0 1 0 0 0 1 
1 0 0 0 0 * 0 0 0 0 0 0 1 0 0 0 1 
1 0 0 0 0 0 * * * 0 0 0 1 0 0 0 1 
1 0 0 0 1 1 1 1 1 * * * 1 0 0 0 4 
1 0 0 0 1 0 0 0 0 0 0 0 * 0 0 0 1 
1 0 0 0 1 0 0 0 0 0 0 0 0 0 0 0 1 
1 0 0 0 1 0 0 0 0 0 0 0 0 0 0 0 1 
1 1 1 1 1 1 1 1 1 1 1 1 1 1 1 1 1 

Iteración (movimiento) 64 - Agente se mueve a: (12, 13)  g=88
Camino recorrido por el agente (marcado con 2):
1 1 1 1 1 1 1 1 1 1 1 1 1 1 1 1 1 
1 0 0 0 1 0 0 0 0 0 0 0 0 0 0 0 1 
1 0 0 0 1 0 0 0 0 0 0 0 0 0 0 0 1 
1 0 0 0 1 0 0 0 0 0 0 0 0 0 0 0 1 
3 0 0 0 1 0 0 0 1 0 0 0 1 1 1 1 1 
1 * 0 0 1 0 0 0 1 0 0 0 1 0 0 0 1 
1 0 * 0 1 0 0 0 1 0 0 0 1 0 0 0 1 
1 0 0 * 1 0 0 0 1 0 0 0 1 0 0 0 1 
1 0 0 * 1 1 1 1 1 0 0 0 1 0 0 0 1 
1 0 0 0 * 0 0 0 0 0 0 0 1 0 0 0 1 
1 0 0 0 0 * 0 0 0 0 0 0 1 0 0 0 1 
1 0 0 0 0 0 * * * 0 0 0 1 0 0 0 1 
1 0 0 0 1 1 1 1 1 * * * 1 * 0 0 4 
1 0 0 0 1 0 0 0 0 0 0 0 * 0 0 0 1 
1 0 0 0 1 0 0 0 0 0 0 0 0 0 0 0 1 
1 0 0 0 1 0 0 0 0 0 0 0 0 0 0 0 1 
1 1 1 1 1 1 1 1 1 1 1 1 1 1 1 1 1 

Iteración (movimiento) 71 - Agente se mueve a: (12, 14)  g=93
Camino recorrido por el agente (marcado con 2):
1 1 1 1 1 1 1 1 1 1 1 1 1 1 1 1 1 
1 0 0 0 1 0 0 0 0 0 0 0 0 0 0 0 1 
1 0 0 0 1 0 0 0 0 0 0 0 0 0 0 0 1 
1 0 0 0 1 0 0 0 0 0 0 0 0 0 0 0 1 
3 0 0 0 1 0 0 0 1 0 0 0 1 1 1 1 1 
1 * 0 0 1 0 0 0 1 0 0 0 1 0 0 0 1 
1 0 * 0 1 0 0 0 1 0 0 0 1 0 0 0 1 
1 0 0 * 1 0 0 0 1 0 0 0 1 0 0 0 1 
1 0 0 * 1 1 1 1 1 0 0 0 1 0 0 0 1 
1 0 0 0 * 0 0 0 0 0 0 0 1 0 0 0 1 
1 0 0 0 0 * 0 0 0 0 0 0 1 0 0 0 1 
1 0 0 0 0 0 * * * 0 0 0 1 0 0 0 1 
1 0 0 0 1 1 1 1 1 * * * 1 * * 0 4 
1 0 0 0 1 0 0 0 0 0 0 0 * 0 0 0 1 
1 0 0 0 1 0 0 0 0 0 0 0 0 0 0 0 1 
1 0 0 0 1 0 0 0 0 0 0 0 0 0 0 0 1 
1 1 1 1 1 1 1 1 1 1 1 1 1 1 1 1 1 

Iteración (movimiento) 76 - Agente se mueve a: (12, 15)  g=98
Camino recorrido por el agente (marcado con 2):
1 1 1 1 1 1 1 1 1 1 1 1 1 1 1 1 1 
1 0 0 0 1 0 0 0 0 0 0 0 0 0 0 0 1 
1 0 0 0 1 0 0 0 0 0 0 0 0 0 0 0 1 
1 0 0 0 1 0 0 0 0 0 0 0 0 0 0 0 1 
3 0 0 0 1 0 0 0 1 0 0 0 1 1 1 1 1 
1 * 0 0 1 0 0 0 1 0 0 0 1 0 0 0 1 
1 0 * 0 1 0 0 0 1 0 0 0 1 0 0 0 1 
1 0 0 * 1 0 0 0 1 0 0 0 1 0 0 0 1 
1 0 0 * 1 1 1 1 1 0 0 0 1 0 0 0 1 
1 0 0 0 * 0 0 0 0 0 0 0 1 0 0 0 1 
1 0 0 0 0 * 0 0 0 0 0 0 1 0 0 0 1 
1 0 0 0 0 0 * * * 0 0 0 1 0 0 0 1 
1 0 0 0 1 1 1 1 1 * * * 1 * * * 4 
1 0 0 0 1 0 0 0 0 0 0 0 * 0 0 0 1 
1 0 0 0 1 0 0 0 0 0 0 0 0 0 0 0 1 
1 0 0 0 1 0 0 0 0 0 0 0 0 0 0 0 1 
1 1 1 1 1 1 1 1 1 1 1 1 1 1 1 1 1 

Iteración (movimiento) 80 - Agente se mueve a: (12, 16)  g=103
Camino recorrido por el agente (marcado con 2):
1 1 1 1 1 1 1 1 1 1 1 1 1 1 1 1 1 
1 0 0 0 1 0 0 0 0 0 0 0 0 0 0 0 1 
1 0 0 0 1 0 0 0 0 0 0 0 0 0 0 0 1 
1 0 0 0 1 0 0 0 0 0 0 0 0 0 0 0 1 
3 0 0 0 1 0 0 0 1 0 0 0 1 1 1 1 1 
1 * 0 0 1 0 0 0 1 0 0 0 1 0 0 0 1 
1 0 * 0 1 0 0 0 1 0 0 0 1 0 0 0 1 
1 0 0 * 1 0 0 0 1 0 0 0 1 0 0 0 1 
1 0 0 * 1 1 1 1 1 0 0 0 1 0 0 0 1 
1 0 0 0 * 0 0 0 0 0 0 0 1 0 0 0 1 
1 0 0 0 0 * 0 0 0 0 0 0 1 0 0 0 1 
1 0 0 0 0 0 * * * 0 0 0 1 0 0 0 1 
1 0 0 0 1 1 1 1 1 * * * 1 * * * 4 
1 0 0 0 1 0 0 0 0 0 0 0 * 0 0 0 1 
1 0 0 0 1 0 0 0 0 0 0 0 0 0 0 0 1 
1 0 0 0 1 0 0 0 0 0 0 0 0 0 0 0 1 
1 1 1 1 1 1 1 1 1 1 1 1 1 1 1 1 1 

Laberinto resuelto:
Número de muros: 98
Porcentaje de muros: 33.91%
Entrada: (4, 0)
Salida: (12, 16)
Coste: 103
Número de nodos generados: 103
Número de nodos inspeccionados: 80
Laberinto actual:
1 1 1 1 1 1 1 1 1 1 1 1 1 1 1 1 1 
1 0 0 0 1 0 0 0 0 0 0 0 0 0 0 0 1 
1 0 0 0 1 0 0 0 0 0 0 0 0 0 0 0 1 
1 0 0 0 1 0 0 0 0 0 0 0 0 0 0 0 1 
3 0 0 0 1 0 0 0 1 0 0 0 1 1 1 1 1 
1 * 0 0 1 0 0 0 1 0 0 0 1 0 0 0 1 
1 0 * 0 1 0 0 0 1 0 0 0 1 0 0 0 1 
1 0 0 * 1 0 0 0 1 0 0 0 1 0 0 0 1 
1 0 0 * 1 1 1 1 1 0 0 0 1 0 0 0 1 
1 0 0 0 * 0 0 0 0 0 0 0 1 0 0 0 1 
1 0 0 0 0 * 0 0 0 0 0 0 1 0 0 0 1 
1 0 0 0 0 0 * * * 0 0 0 1 0 0 0 1 
1 0 0 0 1 1 1 1 1 * * * 1 * * * 4 
1 0 0 0 1 0 0 0 0 0 0 0 * 0 0 0 1 
1 0 0 0 1 0 0 0 0 0 0 0 0 0 0 0 1 
1 0 0 0 1 0 0 0 0 0 0 0 0 0 0 0 1 
1 1 1 1 1 1 1 1 1 1 1 1 1 1 1 1 1 
