Laberinto resuelto:
Número de muros: 98
Porcentaje de muros: 33.91%
Entrada: (4, 0)
Salida: (12, 16)
Coste: 103
Número de nodos generados: 103
Número de nodos inspeccionados: 80
Laberinto actual:
1 1 1 1 1 1 1 1 1 1 1 1 1 1 1 1 1 
1 0 0 0 1 0 0 0 0 0 0 0 0 0 0 0 1 
1 0 0 0 1 0 0 0 0 0 0 0 0 0 0 0 1 
1 0 0 0 1 0 0 0 0 0 0 0 0 0 0 0 1 
3 0 0 0 1 0 0 0 1 0 0 0 1 1 1 1 1 
1 2 0 0 1 0 0 0 1 0 0 0 1 0 0 0 1 
1 0 2 0 1 0 0 0 1 0 0 0 1 0 0 0 1 
1 0 0 2 1 0 0 0 1 0 0 0 1 0 0 0 1 
1 0 0 2 1 1 1 1 1 0 0 0 1 0 0 0 1 
1 0 0 0 2 0 0 0 0 0 0 0 1 0 0 0 1 
1 0 0 0 0 2 0 0 0 0 0 0 1 0 0 0 1 
1 0 0 0 0 0 2 2 2 0 0 0 1 0 0 0 1 
1 0 0 0 1 1 1 1 1 2 2 2 1 2 2 2 4 
1 0 0 0 1 0 0 0 0 0 0 0 2 0 0 0 1 
1 0 0 0 1 0 0 0 0 0 0 0 0 0 0 0 1 
1 0 0 0 1 0 0 0 0 0 0 0 0 0 0 0 1 
1 1 1 1 1 1 1 1 1 1 1 1 1 1 1 1 1 
