Iteración (movimiento) 2 - Agente se mueve a: (5, 1)  g=7
Camino recorrido por el agente (marcado con 2):
1 1 1 1 1 1 1 1 1 1 1 1 1 1 1 1 1 
1 0 0 0 1 0 0 0 0 0 0 0 0 0 0 0 1 
1 0 0 0 1 0 0 0 0 0 0 0 0 0 0 0 1 
1 0 0 0 1 0 0 0 0 0 0 0 0 0 0 0 1 
3 0 0 0 1 0 0 0 1 0 0 0 1 1 1 1 1 
1 2 0 0 1 0 0 0 1 0 0 0 1 0 0 0 1 
1 0 0 0 1 0 0 0 1 0 0 0 1 0 0 0 1 
1 0 0 0 1 0 0 0 1 0 0 0 1 0 0 0 1 
1 0 0 0 1 1 1 1 1 0 0 0 1 0 0 0 1 
1 0 0 0 0 0 0 0 0 0 0 0 1 0 0 0 1 
1 0 0 0 0 0 0 0 0 0 0 0 1 0 0 0 1 
1 0 0 0 0 0 0 0 0 0 0 0 1 0 0 0 1 
1 0 0 0 1 1 1 1 1 0 0 0 1 0 0 0 4 
1 0 0 0 1 0 0 0 0 0 0 0 0 0 0 0 1 
1 0 0 0 1 0 0 0 0 0 0 0 0 0 0 0 1 
1 0 0 0 1 0 0 0 0 0 0 0 0 0 0 0 1 
1 1 1 1 1 1 1 1 1 1 1 1 1 1 1 1 1 

Iteración (movimiento) 4 - Agente se mueve a: (6, 2)  g=14
Camino recorrido por el agente (marcado con 2):
0 0 1 0 0 1 1 1 0 0 0 0 0 0 1 0 0 
1 0 0 0 1 0 0 0 1 0 1 0 1 0 0 1 0 
0 0 0 0 0 0 0 0 0 0 1 0 0 0 0 1 1 
1 0 0 0 0 0 1 1 0 0 0 0 0 0 0 0 0 
3 0 1 1 0 1 0 0 0 0 1 0 0 0 0 0 0 
0 2 0 0 1 0 0 1 0 1 0 0 0 0 0 1 0 
0 0 2 1 0 0 1 1 1 0 0 0 0 1 0 0 0 
0 0 0 0 1 0 0 0 1 1 0 1 0 0 0 1 1 
0 1 0 0 0 0 0 0 0 0 0 1 0 0 0 0 0 
0 0 0 0 0 0 0 0 0 0 0 0 1 0 0 0 0 
0 1 1 0 1 1 0 0 1 1 0 0 0 0 1 0 0 
0 0 1 0 0 1 0 1 0 0 0 0 1 0 0 0 0 
1 0 0 1 1 1 1 0 0 1 0 1 1 1 1 0 4 
0 1 1 0 1 0 1 0 0 0 0 1 1 0 0 0 0 
0 0 0 0 0 1 0 0 0 0 0 0 0 0 1 0 0 
0 0 0 0 0 0 0 0 0 0 0 1 0 0 0 0 1 
0 0 0 0 0 0 0 0 0 0 0 0 0 1 0 0 1 

Iteración (movimiento) 7 - Agente se mueve a: (6, 3)  g=19
Camino recorrido por el agente (marcado con 2):
0 1 0 0 0 0 0 0 0 0 0 0 0 0 1 0 0 
0 0 0 1 0 1 1 0 0 0 0 1 0 1 0 0 0 
0 0 0 0 0 0 0 0 0 1 0 0 1 1 0 1 1 
1 0 0 1 1 0 0 0 0 0 1 0 0 0 1 0 0 
3 0 1 1 1 1 0 0 0 0 1 0 0 0 0 1 0 
0 2 0 0 0 0 1 0 0 0 0 1 0 1 0 1 0 
1 0 2 2 1 1 0 0 0 0 0 1 0 0 0 0 0 
0 1 1 0 1 0 1 0 0 0 1 0 0 0 0 0 0 
0 0 0 0 0 0 0 0 0 0 1 0 0 0 0 0 0 
0 0 0 0 0 0 1 0 0 1 0 0 1 1 0 0 0 
1 0 1 0 0 0 0 0 0 0 0 0 0 0 0 1 1 
0 1 0 0 0 1 0 1 0 0 0 0 0 0 1 1 0 
0 0 0 1 0 0 0 0 0 0 1 0 1 0 0 0 4 
1 0 0 0 0 0 0 0 1 1 1 0 0 0 0 0 1 
0 1 1 1 0 1 0 0 1 0 0 0 0 0 0 0 0 
0 1 1 0 0 0 1 0 0 0 0 0 0 0 1 0 0 
0 0 0 1 1 1 0 1 0 1 0 0 0 0 0 0 0 

Iteración (movimiento) 10 - Agente se mueve a: (6, 4)  g=24
Camino recorrido por el agente (marcado con 2):
0 0 0 0 0 0 0 0 0 0 0 0 0 0 0 0 0 
1 1 0 0 0 0 0 0 1 1 1 0 0 0 0 1 0 
1 0 0 0 0 0 0 1 1 0 0 0 1 0 0 0 0 
0 1 0 1 0 0 0 0 0 1 0 0 0 0 1 0 1 
3 0 0 0 0 1 1 0 1 0 0 1 1 1 0 0 0 
1 2 0 0 0 0 0 0 0 0 0 0 0 0 0 0 1 
0 0 2 2 2 1 0 0 0 0 0 0 0 0 0 1 1 
0 0 0 0 0 0 1 1 0 0 0 0 0 0 0 0 0 
0 0 0 1 0 1 0 0 0 0 1 1 1 0 1 0 1 
1 1 0 1 0 0 0 0 0 0 0 1 1 1 0 0 0 
0 0 0 1 0 1 0 0 0 0 1 0 0 1 0 1 1 
0 0 0 0 0 1 0 0 1 1 0 0 0 0 0 1 1 
0 0 0 1 0 0 0 0 0 1 0 0 0 1 0 0 4 
1 0 1 0 0 0 0 0 1 1 0 0 1 0 0 0 0 
0 0 0 1 0 0 1 0 1 0 0 0 0 0 1 0 0 
0 0 0 0 0 0 0 0 0 0 0 1 0 1 0 0 0 
1 1 0 0 0 0 0 0 0 1 1 0 0 0 0 1 1 

Iteración (movimiento) 15 - Agente se mueve a: (7, 5)  g=31
Camino recorrido por el agente (marcado con 2):
0 0 1 0 0 0 0 0 0 0 1 0 0 0 1 0 0 
0 0 0 0 1 0 0 0 0 0 0 0 1 0 0 0 0 
0 1 0 1 0 1 0 0 0 0 0 0 0 0 0 0 0 
1 1 0 0 0 0 0 1 0 1 0 0 0 0 0 0 0 
3 1 0 0 0 1 1 0 0 0 0 0 0 0 0 1 1 
1 2 0 0 1 1 1 0 0 0 0 0 1 0 0 0 1 
0 1 2 2 2 1 1 0 0 1 0 0 1 0 0 0 0 
0 1 0 1 1 2 0 0 0 0 0 0 0 0 0 0 1 
0 0 0 0 1 0 0 1 0 1 1 0 0 0 0 0 0 
0 0 0 0 0 1 0 1 0 0 0 0 1 0 1 0 0 
1 0 0 0 0 0 1 0 1 0 0 0 0 0 0 1 0 
0 1 0 0 1 1 0 1 1 0 1 0 1 0 0 0 1 
0 1 0 0 0 0 1 1 0 1 0 0 0 0 0 0 4 
0 0 0 1 1 0 1 0 0 0 0 0 0 0 1 0 0 
0 1 0 0 0 0 0 0 0 0 0 1 0 0 0 1 1 
0 0 1 1 1 0 0 0 0 0 0 0 0 1 1 0 1 
0 0 0 0 1 1 0 0 0 0 0 0 0 0 0 0 0 

Iteración (movimiento) 18 - Agente se mueve a: (8, 6)  g=38
Camino recorrido por el agente (marcado con 2):
1 0 0 0 1 0 0 0 0 0 0 0 0 1 0 1 1 
0 1 0 0 0 1 0 0 0 1 0 0 1 1 0 0 1 
0 1 0 1 0 0 0 0 0 1 1 0 0 1 0 0 0 
1 0 0 0 0 1 1 0 0 1 0 0 0 0 0 0 0 
3 0 1 0 0 0 1 0 0 0 0 0 0 1 0 0 0 
0 2 0 0 0 1 1 0 1 0 0 0 0 0 0 0 0 
1 1 2 2 2 0 0 0 0 0 0 0 0 0 1 0 0 
1 0 0 1 1 2 0 1 0 1 0 0 0 0 0 0 1 
1 0 0 0 1 1 2 0 0 1 1 0 0 0 0 0 0 
0 0 0 1 1 0 0 0 1 0 1 0 0 0 0 0 1 
0 0 0 1 0 0 0 0 1 0 0 1 0 1 0 1 0 
0 0 1 0 1 0 0 0 1 0 1 0 0 0 0 0 0 
0 0 0 0 0 1 0 0 1 1 0 1 0 0 0 0 4 
1 1 0 0 0 0 0 1 0 1 0 0 0 0 0 0 1 
0 0 0 0 1 0 0 0 0 0 1 0 0 0 0 0 1 
0 0 0 0 0 0 0 1 0 0 0 0 0 0 1 1 0 
0 0 0 1 0 0 0 0 1 0 0 0 1 0 0 0 0 

Iteración (movimiento) 23 - Agente se mueve a: (9, 7)  g=45
Camino recorrido por el agente (marcado con 2):
0 1 1 0 0 0 0 0 0 0 0 0 0 0 0 0 0 
0 0 1 0 1 0 0 0 1 1 0 1 0 0 1 0 0 
0 1 0 1 0 0 0 0 0 1 0 0 1 0 1 1 0 
0 1 0 0 0 0 0 1 0 0 0 0 1 0 0 0 0 
3 0 0 0 0 1 0 0 1 0 0 0 1 0 0 0 0 
0 2 0 1 0 0 0 0 0 1 1 0 0 0 0 0 0 
0 0 2 2 2 0 0 0 0 0 0 1 0 0 0 0 1 
0 1 0 1 1 2 1 0 0 0 0 0 0 0 0 1 1 
0 0 1 0 1 0 2 1 1 1 0 0 1 1 1 0 0 
0 1 0 0 0 0 0 2 0 0 0 1 0 0 0 0 0 
0 0 0 0 0 1 0 1 0 1 0 0 1 0 0 0 0 
0 0 1 0 0 1 0 0 1 1 0 0 0 0 0 0 0 
0 1 1 0 0 1 1 0 1 0 1 0 1 0 0 0 4 
0 1 0 0 0 0 0 0 0 1 1 0 0 0 0 0 0 
0 0 1 0 0 0 0 0 0 0 0 1 0 1 1 0 0 
1 0 1 0 0 1 0 0 0 0 1 0 0 0 1 0 0 
0 0 1 0 0 0 0 0 0 0 0 0 1 0 1 0 1 

Iteración (movimiento) 35 - Agente se mueve a: (10, 8)  g=52
Camino recorrido por el agente (marcado con 2):
0 0 1 0 0 0 0 1 1 0 0 1 1 1 0 1 0 
1 1 0 0 0 1 0 1 0 0 1 0 0 1 0 0 0 
0 1 0 1 0 0 0 0 0 0 0 0 1 0 0 0 0 
1 0 1 1 0 0 0 1 1 1 0 1 1 0 0 1 0 
3 0 0 0 0 0 0 0 0 1 0 0 1 0 0 0 0 
1 2 0 1 0 0 0 0 1 1 0 0 1 0 0 0 1 
0 1 2 2 2 0 0 1 0 0 0 0 0 1 0 0 0 
0 1 0 1 0 2 0 0 0 0 0 0 0 0 0 1 0 
0 0 0 0 0 0 2 0 1 0 0 0 0 0 1 0 0 
1 0 1 0 1 0 1 2 0 0 0 0 0 0 0 0 0 
0 0 0 1 1 0 1 1 2 1 0 0 1 1 0 1 1 
0 0 0 0 0 0 0 1 0 0 0 0 0 1 0 0 0 
1 0 1 1 0 0 0 0 0 1 0 0 0 0 0 0 4 
0 0 0 1 0 1 0 0 0 0 1 0 0 0 0 0 0 
1 0 0 0 0 0 0 0 0 0 1 0 1 0 0 0 0 
1 0 0 0 0 1 0 0 0 0 0 0 0 1 0 0 0 
0 0 1 0 0 0 0 1 0 0 0 0 0 0 0 1 0 

Iteración (movimiento) 39 - Agente se mueve a: (11, 9)  g=59
Camino recorrido por el agente (marcado con 2):
1 0 0 0 0 0 1 0 0 1 1 1 0 1 0 0 1 
0 1 0 0 0 0 0 1 0 1 0 0 0 1 0 0 1 
0 0 0 0 0 0 0 1 0 0 0 0 0 0 1 0 0 
1 1 0 0 0 0 0 0 0 1 0 0 0 0 0 0 0 
3 1 1 0 0 0 0 1 1 0 0 1 1 0 0 0 0 
0 2 0 0 1 0 0 0 0 1 0 0 1 0 0 0 0 
0 0 2 2 2 1 1 0 0 0 0 1 0 0 0 0 1 
0 0 0 0 0 2 0 1 0 0 0 0 0 1 1 1 0 
0 0 0 0 0 1 2 0 0 0 1 0 0 0 0 0 1 
0 0 0 0 1 0 1 2 0 0 0 0 1 1 0 0 0 
0 0 0 0 1 0 0 1 2 0 0 1 1 0 0 0 0 
0 1 1 1 0 1 0 0 0 2 0 0 0 0 1 1 0 
0 1 0 0 0 0 0 0 0 1 1 1 1 0 1 0 4 
0 1 0 1 0 0 0 1 0 0 0 0 0 0 0 1 0 
0 0 0 1 0 0 0 0 0 0 0 1 1 0 0 0 0 
0 0 0 1 1 0 0 0 0 0 0 0 0 0 0 1 1 
0 0 0 1 0 1 1 0 0 0 0 0 0 0 1 0 0 

Iteración (movimiento) 50 - Agente se mueve a: (12, 10)  g=66
Camino recorrido por el agente (marcado con 2):
1 1 0 1 0 0 0 0 0 0 0 1 1 0 0 0 0 
0 0 0 0 0 0 0 1 0 0 0 0 0 1 0 0 1 
0 0 0 0 1 1 1 1 0 0 0 1 0 0 0 1 0 
0 0 0 1 1 0 0 1 1 0 0 0 1 0 0 1 1 
3 1 1 0 0 0 1 0 1 0 0 0 1 1 0 0 0 
1 2 0 1 0 0 0 0 0 0 0 0 0 0 0 0 0 
0 0 2 2 2 1 0 0 0 1 0 1 0 0 0 0 1 
0 1 0 0 0 2 0 0 0 0 0 0 0 1 1 0 0 
0 0 1 0 0 1 2 0 0 0 1 1 0 0 0 0 1 
1 0 0 1 0 0 0 2 0 0 1 0 0 1 0 0 0 
0 0 0 0 1 1 1 0 2 1 0 0 0 0 0 0 1 
1 0 1 0 1 0 0 0 1 2 0 0 0 0 0 1 1 
1 0 0 0 1 0 1 0 0 0 2 0 0 0 0 0 4 
0 0 0 0 0 0 0 0 0 0 0 1 0 0 0 1 0 
1 1 0 0 0 0 1 1 0 0 0 0 0 0 0 0 0 
0 1 0 0 0 1 0 0 0 1 0 1 0 0 1 0 0 
0 0 0 0 1 0 0 0 0 0 0 0 0 0 0 0 1 

Iteración (movimiento) 63 - Agente se mueve a: (12, 11)  g=71
Camino recorrido por el agente (marcado con 2):
0 0 0 0 1 0 1 0 0 1 0 0 0 0 1 0 1 
0 0 0 0 0 1 0 0 1 1 0 0 1 0 0 1 0 
0 0 0 0 1 0 0 0 0 0 1 1 0 1 0 1 0 
0 0 0 1 0 0 0 0 0 0 0 0 0 0 0 0 0 
3 0 1 0 0 0 0 0 1 0 0 0 0 0 0 0 0 
1 2 1 0 0 0 0 0 0 0 1 0 0 0 1 0 0 
1 1 2 2 2 1 1 0 0 1 0 1 0 0 0 0 1 
0 0 0 0 1 2 0 1 0 0 0 0 0 0 0 0 0 
0 0 1 0 0 1 2 1 1 1 0 1 0 0 0 0 0 
0 0 0 0 0 1 0 2 0 0 1 0 0 1 0 0 1 
1 1 1 0 0 0 1 1 2 0 0 0 0 0 0 0 0 
1 0 0 0 1 0 0 0 0 2 0 0 1 0 0 0 0 
0 1 0 1 0 0 0 0 0 0 2 2 1 0 0 0 4 
0 1 0 0 1 0 0 0 1 0 0 1 0 0 1 0 1 
0 1 0 0 1 0 0 0 1 0 0 0 0 1 0 0 1 
0 1 0 0 0 0 1 0 0 1 0 0 1 1 0 0 0 
0 0 0 1 0 0 0 1 0 1 0 0 1 0 0 0 0 

Iteración (movimiento) 105 - Agente se mueve a: (13, 12)  g=78
Camino recorrido por el agente (marcado con 2):
0 1 1 0 0 0 0 0 0 0 0 0 0 0 0 0 0 
0 0 0 1 0 0 1 0 0 1 0 0 0 0 0 0 1 
0 0 1 0 0 0 1 0 0 0 0 0 0 0 0 1 0 
0 1 0 0 1 0 0 0 0 0 0 0 1 0 0 1 1 
3 0 0 0 0 1 0 0 0 0 0 0 0 1 1 1 0 
0 2 0 0 1 0 0 0 1 0 0 0 0 0 1 1 0 
1 1 2 2 2 0 1 0 1 0 0 0 1 1 0 0 1 
1 0 0 0 0 2 0 0 1 0 1 1 0 0 0 0 0 
0 0 0 0 1 0 2 0 1 1 0 0 0 0 0 0 0 
0 0 0 0 0 0 1 2 1 0 0 0 1 0 0 1 0 
1 0 0 1 0 0 0 1 2 0 0 0 0 0 0 1 0 
0 1 1 1 0 1 0 0 0 2 0 0 0 0 0 0 0 
1 0 1 0 0 0 0 0 1 0 2 2 0 0 0 0 4 
0 0 0 0 1 0 0 0 1 0 0 1 2 1 1 0 0 
0 0 1 0 1 0 0 1 1 0 0 0 0 0 0 1 0 
0 1 0 0 0 0 1 1 1 0 0 0 0 0 1 0 0 
1 0 0 0 0 0 1 0 0 1 0 1 0 1 0 0 1 

Iteración (movimiento) 113 - Agente se mueve a: (12, 13)  g=85
Camino recorrido por el agente (marcado con 2):
0 0 0 0 0 1 1 0 1 0 0 0 0 0 0 0 0 
0 1 1 0 0 1 0 0 0 0 0 0 1 0 1 0 0 
0 0 0 1 0 0 0 0 0 0 1 0 1 1 0 0 0 
0 0 0 1 1 0 1 0 0 0 0 0 0 0 0 0 1 
3 1 1 0 0 0 0 0 0 0 1 1 0 0 1 0 1 
0 2 0 0 0 0 0 0 0 0 0 0 0 0 0 0 1 
0 0 2 2 2 1 0 1 0 0 0 0 0 0 0 0 0 
0 0 0 0 1 2 1 1 1 0 0 0 1 1 0 1 0 
0 0 0 0 0 0 2 0 0 0 1 0 0 1 0 0 0 
0 1 0 0 0 0 0 2 0 0 0 0 1 0 0 0 0 
1 0 1 0 1 0 1 0 2 0 1 0 1 0 0 0 0 
1 0 0 1 1 0 1 1 0 2 0 0 0 0 0 1 0 
0 0 0 0 0 0 0 0 1 0 2 2 0 2 1 1 4 
0 1 1 1 0 0 1 1 0 0 1 0 2 0 0 0 1 
0 0 1 0 1 0 1 0 0 0 1 0 0 0 1 1 0 
0 1 0 0 0 0 0 0 1 0 1 0 0 0 1 0 1 
0 0 0 1 0 0 0 0 0 1 0 0 0 1 0 0 0 

Iteración (movimiento) 126 - Agente se mueve a: (12, 14)  g=90
Camino recorrido por el agente (marcado con 2):
0 1 0 0 0 0 0 0 0 0 1 1 0 0 0 0 1 
0 0 1 0 0 1 0 0 0 0 0 0 0 1 0 0 0 
0 0 0 1 0 1 0 0 0 0 1 0 0 1 0 0 0 
0 0 0 0 0 1 1 0 0 0 0 0 0 0 1 1 0 
3 0 0 0 1 1 0 0 0 0 0 0 1 1 0 0 0 
0 2 0 1 0 1 1 0 0 0 1 0 0 0 0 0 1 
0 0 2 2 2 1 0 1 0 0 0 0 0 0 0 1 1 
1 0 0 0 0 2 0 1 1 0 1 0 0 0 0 0 1 
0 1 0 1 1 0 2 0 0 0 0 0 0 0 1 0 0 
0 0 0 1 0 0 0 2 0 0 1 1 0 0 1 1 0 
0 0 0 0 0 0 1 1 2 1 0 0 1 1 0 1 0 
0 0 0 0 1 0 0 0 0 2 1 0 0 0 0 0 0 
0 0 0 0 1 1 0 0 0 0 2 2 1 2 2 0 4 
0 1 0 0 0 1 1 0 1 0 1 1 2 0 0 0 0 
0 0 1 0 1 0 1 0 0 0 0 0 0 1 0 0 1 
0 0 0 0 1 0 0 0 0 0 1 0 1 0 0 0 0 
0 1 1 0 0 1 0 0 1 0 0 0 1 0 0 0 0 

Iteración (movimiento) 140 - Agente se mueve a: (12, 15)  g=95
Camino recorrido por el agente (marcado con 2):
1 0 1 0 1 0 1 0 1 0 0 0 0 0 0 1 0 
0 0 0 0 0 1 0 0 0 1 0 0 0 0 0 0 0 
0 1 0 0 0 0 1 0 0 0 0 0 1 1 0 0 1 
0 0 1 0 1 1 1 0 0 0 0 0 0 0 0 0 1 
3 1 0 0 0 0 1 0 0 0 0 0 0 0 0 0 0 
0 2 0 0 0 1 0 0 0 1 1 0 1 1 0 1 0 
0 1 2 2 2 0 0 0 0 1 0 1 0 1 0 0 0 
0 1 1 1 0 2 0 0 0 1 0 0 0 0 0 0 0 
1 0 0 1 1 0 2 0 0 1 1 0 0 1 0 0 0 
1 0 0 0 0 0 0 2 0 0 0 1 0 1 0 1 0 
0 0 0 1 1 0 0 0 2 0 1 0 0 0 1 0 0 
0 1 0 1 0 0 0 0 1 2 0 0 0 0 0 0 0 
1 0 0 0 0 0 1 1 1 0 2 2 1 2 2 2 4 
1 0 1 1 0 0 0 0 0 0 0 0 2 0 0 0 0 
0 0 0 0 0 0 0 0 1 1 0 0 0 0 1 1 1 
1 0 0 0 1 0 0 0 1 1 0 1 0 0 1 0 0 
0 0 0 0 1 0 0 0 0 0 0 0 0 0 0 1 0 

Iteración (movimiento) 153 - Agente se mueve a: (12, 16)  g=100
Camino recorrido por el agente (marcado con 2):
0 1 0 0 1 0 0 0 0 1 1 1 0 0 0 0 0 
1 1 0 1 0 0 0 0 0 0 0 1 1 0 0 0 0 
1 1 0 0 0 1 0 0 1 1 0 0 0 0 0 0 0 
0 0 0 0 0 0 0 0 1 0 0 1 0 0 0 0 0 
3 0 0 0 0 0 1 0 0 1 0 1 0 0 0 0 0 
1 2 1 0 0 0 0 0 0 0 0 0 0 1 0 0 0 
1 0 2 2 2 0 1 0 0 0 0 0 0 0 0 0 0 
1 0 1 0 1 2 0 0 1 1 1 0 0 0 1 0 0 
0 0 1 0 0 0 2 0 0 1 1 1 0 1 0 0 0 
1 0 0 1 0 0 0 2 0 0 0 1 1 0 0 1 0 
0 0 0 0 0 0 0 1 2 1 0 1 1 0 0 0 0 
0 0 0 0 0 0 0 0 0 2 0 0 1 0 1 0 0 
1 0 0 0 0 0 0 0 0 1 2 2 0 2 2 2 4 
0 0 0 0 1 0 1 0 1 0 0 0 2 0 0 0 1 
1 0 1 0 0 0 0 1 0 0 1 0 0 0 0 1 1 
1 0 0 1 0 1 0 1 0 0 1 0 0 0 0 0 1 
0 1 0 0 1 1 0 0 0 0 0 0 0 0 1 1 1 

Laberinto dinámico resuelto:
Número de muros: 72
Porcentaje de muros: 24.9135%
Entrada: (4, 0)
Salida: (12, 16)
Coste: 100
Número de nodos generados: 195
Número de nodos inspeccionados: 153
Laberinto actual:
0 1 0 0 1 0 0 0 0 1 1 1 0 0 0 0 0 
1 1 0 1 0 0 0 0 0 0 0 1 1 0 0 0 0 
1 1 0 0 0 1 0 0 1 1 0 0 0 0 0 0 0 
0 0 0 0 0 0 0 0 1 0 0 1 0 0 0 0 0 
3 0 0 0 0 0 1 0 0 1 0 1 0 0 0 0 0 
1 2 1 0 0 0 0 0 0 0 0 0 0 1 0 0 0 
1 0 2 2 2 0 1 0 0 0 0 0 0 0 0 0 0 
1 0 1 0 1 2 0 0 1 1 1 0 0 0 1 0 0 
0 0 1 0 0 0 2 0 0 1 1 1 0 1 0 0 0 
1 0 0 1 0 0 0 2 0 0 0 1 1 0 0 1 0 
0 0 0 0 0 0 0 1 2 1 0 1 1 0 0 0 0 
0 0 0 0 0 0 0 0 0 2 0 0 1 0 1 0 0 
1 0 0 0 0 0 0 0 0 1 2 2 0 2 2 2 4 
0 0 0 0 1 0 1 0 1 0 0 0 2 0 0 0 1 
1 0 1 0 0 0 0 1 0 0 1 0 0 0 0 1 1 
1 0 0 1 0 1 0 1 0 0 1 0 0 0 0 0 1 
0 1 0 0 1 1 0 0 0 0 0 0 0 0 1 1 1 
